79 79
2222222222222222222222222222222222222222222222222222222222222222222222222222222
2000000000000000000000000010001000100010000010000000100000100010000010001000002
2000010110001000000110111010101010101010111010101110101110101010101010101111102
2000100000100001101000101000101010001010100010100010001000101010101010100000002
2110111011101100101111101010101101111010101110101011011011101010101010111111102
2010100010001000000010001010100000001000101000101000000010001010101000100000102
2010101000101011101010111010111010101110101011101111011110111011101111101111102
2000101010101010001000101010100010101000101000101010000000101000100000100000002
2011101000100011101011101010101110101011101110101010111011101110101010111111112
2010000010000000100000101010101010100010101010100000100000101000101010000000102
2010101111000110111110101011101010101010101010111011101110101011111011111110102
2010101000100010100000000010001010101010001010001000000000001000001000100000002
2010101010001010101111011110111010101011111011101111101110111111101010101111112
2000101010101000001000000010000010100010001000000010000000000000101010100010002
2111101110101111101011111011111010111110101111111011101111111110101010111010102
2000000000000000000010001000100010100000100000001010001000001000100010001000102
2011111110111110111110101111101110111110111111101010111011101011111111101111102
2000000000000000100000100000100000000000100000100010000010001010000010100000102
2111111110101111101111111110111110111111101110111111101110111010111010111110102
2000100000101000100000100010100010000000100010001000101000101000101010000000102
2010101111101010111110101010101011111110111011101010111011101111101010111111102
2010000000101010000010001010001000000010001000100010100010001000001000101000002
2011111110101110101111111011111111101010111110111110101111101011111111101011112
2000100010100010101000000010100000101010000010000010100010001010001000001010002
2110101010111011101011111110101110101011111011111011101010111010111011111011102
2000101010101010001010000010001000101000101010001000001010000010001000001000102
2011101010101010111011101111111110101110101010111111101011101111101111101010102
2010001010001010100010001000000000101000001010100010001000100010101000101010002
2011111010111010111110111010101111111010101010101010111110111010101010101011112
2000101010100010000010100010100000000010101010101000100010000010001010100010002
2110101011101110101110111111111111111110101010101111101010111111101010111110102
2000001000100010100010001000100000100010100000100000101010001000101010000000102
2011111110111011111011101110111011101010111110111110101011101010101011111111102
2010000010000000101000100000000010001010100000100010001010001010001010000000102
2010111011111010101110111110101110101110101111101111111010111010111010111110102
2000100000100010000000100010101000100000101000101000000010000010001010100010102
2111111110101111111011111010101011111111101011101011111110111111111010101110102
2000100000001000000010000010101010001000101010000010001000100010100010100010002
2010101110111110111110101110101010101010101010101111101011101010101110111011112
2010001010000010000000100010101010101010001010101000100010001000000010001000002
2011111011111011111111101010101011101011111010101010111010111111111111101010102
2010000010001000100000101010101000001010001000100010100010000000100000101010102
2011111011101110101110101010101111111010101111111110101111111110101110101010102
2000100000000010100010101000100010000010100000001000101000000010100010001010102
2110101111101110111010111111111010111110101110111011101110111010101111111011102
2000001000001000100010100000101010100010100010000010100000100010100010001010002
2111111011111011111010101110101011101011111011111110111111101110111010101010112
2000000010001000100010100010000010001010000000001000100010001000101000100010002
2011111110101110101110101111111010111010111111101010111010111011101111111111102
2000100010100010101000101000000010100010000000101010001000001000101000100000102
2110101011111010101110111011111111101111111110101011101011111010101010101110102
2000101010001000100010001000000010001000000000101000100010000010101010101000102
2011101010101011111011101111111010111111101111101110111110111111101011101011102
2010101010100000001010001000100010100000101000100010100000100000001010001000002
2010101110111011101010111010101110101110101110111010101011101111101010111111112
2000100000100010001010100010100010100010100010001010001010000000101000101000102
2110111111111110111010101110111010111011111011101011111110101110111111101010102
2000100010001000000010001010001000001000100010001010000000100010100000100010102
2011101010101111111111111011101111101110101110111110111111101110101111101110102
2000101000101000100000001000001000101000101000100010100010001000101000001000102
2110101110101011101111101111101011101110101011101010101010111011101011111011102
2000101000100000001000100010001000001000100000001000101000100010000010001000102
2011111011111011111010101010111111111010111111111111101111101111101110111110102
2010001010000010000010101010100010001010001010000000101000100010001000100000102
2010101011111110101110101011101010101010101010101010101011111010111110101111102
2010101010000010101010101010001010100010101000101010101000100000000010001000102
2011101010111011101010101010111011111111101111101011101110101111111011111110102
2000001010101000001000101010101000000000100010001000001000100000001000001000102
2110111110101111101111101010101111111010111010111111111010111111101111101011102
2000100000100000100000001010101000000010000010101000000010101000001000001000002
2011101111101110111111111010101110111111111110101011111110101011111011101011112
2010100010100010100000001010100000100000100000101010000010001000001010001000102
2010111010111110101111101010101111111010101111101011111011111111101011111010102
2010000010001000100010001000101000000010101000100000100010000010001010000010102
2010111111101011111010111111101010111110101010111110111010111010111010111110102
2010100000100000001010100000100010000010101010001010001000001000101010100000102
2010101110111011111010101110101111111110101011101010101111101011101010101111102
2000001000100000000010000010001000000000100010001000100000001000001000100000002
2222222222222222222222222222222222222222222222222222222222222222222222222222222
1 1 77 77